Sheepless
An Interactive Fiction by Sheepness "Sheepies vs Bunnies"
Release 1 / Serial number 170110 / Inform 7 build 6M62 (I6/v6.33 lib 6/12N) SD

Alley
A group of rabbits are beating you to death.

>l
Alley
A group of rabbits are beating you to death.

Ouch.

>n
You can't go that way.

>e
You can't go that way.

>w
You can't go that way.

>s
You can't go that way.

* * *

>l
Alley
A group of rabbits are beating you to death.

Ouch.

>pick up sheep
Taken.

>eat sheep
That's plainly inedible.

>punch sheep
Violence isn't the answer to this one.

>die
That's not a verb I recognise.

>suicide
That's not a verb I recognise.

>kill
(the sheep)
Violence isn't the answer to this one.

>kill myself
Violence isn't the answer to this one.

>help
That's not a verb I recognise.

>showme
Gazebo - room
    yourself - person
        sheep

>showme sheep
sheep - thing
location: carried by yourself in the Gazebo
singular-named, improper-named; unlit, inedible, portable, handled
list grouping key: none
printed name: "sheep"
printed plural name: none
indefinite article: none
description: none
initial appearance: none

* * *

>l
Alley
A group of rabbits are beating you to death.

Ouch.

>pick up group of rabbits
Taken.

>drop
(the group of rabbits)
Dropped.

>l
Alley
You can see a group of rabbits here.

>l
Alley
You can see a group of rabbits here.

>scream
That's not a verb I recognise.

>pick up rabbit
You can't see any such thing.

>showme group of rabbits
group of rabbits - thing
location: in the Alley
singular-named, improper-named; unlit, inedible, portable, handled
list grouping key: none
printed name: "group of rabbits"
printed plural name: none
indefinite article: none
description: none
initial appearance: "A group of rabbits are beating you to death."

* * *

>l
Alley
A group of rabbits are beating you to death.

Ouch.

>l
Alley
A group of rabbits are beating you to death.

Ouch.

>l
Alley
A group of rabbits are beating you to death.

Something explodes. You have died.

? ? ?
You are confronted by a mysterious figure. The figure grants you the power to kill rabbits, saying that it would be hilarious to see what you would do with it. "How the fuck does that work?" you ask. The figure says, "I don't fucking know." The figure then disappears and a room materialises.

>l
Been
Been

>l
Been
Been

* * *

Sheepless
An Interactive Fiction by Sheepness "Sheepies vs Bunnies"
Release 1 / Serial number 170110 / Inform 7 build 6M62 (I6/v6.33 lib 6/12N) SD

Alley
A group of rabbits are beating you to death.

>x asdfhgwenkldsv
You see nothing special about the asdfhgwenkldsv.

* * *

Sheepless
An Interactive Fiction by Sheepness "Sheepies vs Bunnies"
Release 1 / Serial number 170110 / Inform 7 build 6M62 (I6/v6.33 lib 6/12N) SD

Alley
A group of rabbits are beating you to death.

>x
What do you want to examine?

>l
Alley

>l
Alley

>x group of rabbits
You can't see any such thing.

* * *

Sheepless
An Interactive Fiction by Sheepness "Sheepies vs Bunnies"
Release 1 / Serial number 170110 / Inform 7 build 6M62 (I6/v6.33 lib 6/12N) SD

Alley
A group of rabbits are beating you to death.

>pick up group of rabbits
That's fixed in place.

>save
Save failed.

>l
Alley
A group of rabbits are beating you to death.

* * *

Sheepless
An Interactive Fiction by Sheepness "Sheepies vs Bunnies"
Release 1 / Serial number 170110 / Inform 7 build 6M62 (I6/v6.33 lib 6/12N) SD

Alley
A group of rabbits are beating you to death.

>z
Time passes.

>z
Time passes.

Something explodes. You have died.

? ? ?
You are confronted by a mysterious figure. The figure grants you the power to kill rabbits, saying that it would be hilarious to see what you would do with it. "How the fuck does that work?" you ask. The figure says, "I don't fucking know." The figure then delivers a swift left hook to his head and you lose consciousness.

>l
? ? ?

>l
? ? ?
? ? ?

>z
Time passes.

? ? ?

* * *

>z
Time passes.

Something explodes. You have died.

? ? ?
You are confronted by a mysterious figure. The figure grants you the power to kill rabbits, saying that it would be hilarious to see what you would do with it. "How the fuck does that work?" you ask. The figure says, "I don't fucking know." The figure then delivers a swift left hook to his head and you lose consciousness.

>z
Time passes.

>l
? ? ?

>l
? ? ?

I beg your pardon?

>l
? ? ?

* * *

I beg your pardon?

I beg your pardon?

* * *

Sheepless
An Interactive Fiction by Sheepness "Sheepies vs Bunnies"
Release 1 / Serial number 170110 / Inform 7 build 6M62 (I6/v6.33 lib 6/12N) SD

Alley
A group of rabbits are beating you to death.

>scream
But nobody came.

Ouch.

>scream
But nobody came.

Ouch.

>scream
But nobody came.

Something explodes. You have died.

? ? ?
You are confronted by a mysterious figure. The figure then tells you it has granted you the power to kill rabbits, claiming that he did so because it would be hilarious to see how you use it. "So what exactly is this power?" you ask. The figure says, "I don't actually know." The figure then disappears and a room materialises.

Ethereal Space
There is a rabbit branded by a letter O.

There is a rabbit branded by a letter A.

You can also see a doughnut here.

>scream
Shut the fuck up.

>scream
Shut the fuck up.

* * *

>scream
But nobody came.

Something explodes. You have died.

? ? ?
You are confronted by a mysterious figure. The figure then tells you it has granted you the power to kill rabbits, claiming that he did so because it would be hilarious to see how you use it. "So what exactly is this power?" you ask. The figure says, "I don't actually know." The figure then disappears and a room materialises.

Ethereal Space
There is a rabbit branded by a letter O.

There is a rabbit branded by a letter A.

You can also see a doughnut here.

>pick up doughnut
Taken.

>pick up rabbit
Who do you mean, the rabbit or the rabbit?

>x rabbit
Who do you mean, the rabbit or the rabbit?

>eat rabbit
Who do you mean, the rabbit or the rabbit?

>eat doughnut
This one's starting to get quite mouldy… I'm not sure that's a good idea.

>l
Ethereal Space
There is a rabbit branded by a letter O.

There is a rabbit branded by a letter A.

>x rabbit
Who do you mean, the rabbit or the rabbit?

>undo
Ethereal Space
[Previous turn undone.]

>undo
Ethereal Space
[Previous turn undone.]

* * *

>x rabbit
Who do you mean, the rabbit or the rabbit?

>x rabbit with a letter O
Who do you mean, the rabbit or the rabbit?

>x rabbit with a O
You can't see any such thing.

>x rabbit with a letter O
Who do you mean, the rabbit or the rabbit?

>x letter O rabbit
A cute bunny! There is a letter O branded on its side.

>x letter A rabbit
A cute bunny! There is a letter A branded on its side.

* * *

>l
Ethereal Space
There is a rabbit branded by a letter O.

There is a rabbit branded by a letter A.

>l
Ethereal Space
You can see two rabbits here.

>x rabbit
Which rabbit do you want to examine?

>x rabbit with A
You can't see any such thing.

>x rabbit
Which rabbit do you want to examine?

>x rabbits
You can't use multiple objects with that verb.

>x rabbit with a letter A
You can't see any such thing.

>x rabbit with a
You can't see any such thing.